Some pretext about the story...

Explanation of git config... Please only use ONE word for your name (No spaces in between!)

Now use the format "git config --global NAME" to tell me your name.

I beg your pardon?

Now use the format "git config --global NAME" to input your name.

>name
Please use the required format.

Now use the format "git config --global NAME" to input your name.

* * *

Some pretext about the story...

Explanation of git config... Please only use ONE word for your name (No spaces in between!)

Now use the format "git config --global NAME" to tell me your name.

>"git config --global RAM"
Hi, RAM, welcome! Let's begin. 

Adventure of the Command Line
An Interactive Fiction by Ohana
Release 1 / Serial number 240202 / Inform 7 v10.1.2 / D
 

Explain entering rooms problem

RAM's Bedroom
You can see a bedroom door here.

* * *

Some pretext about the story...

Explanation of git config... Please only use ONE word for your name (No spaces in between!)

Now use the format "git config --global NAME" to tell me your name.

>1 2 3 4 5 6
Who are you, a member of the British royal family? No one has that many names. Let's try this again.

What is your name?

>1 2 3 4 5
Hi, 1!

Adventure of the Command Line
An Interactive Fiction by Ohana
Release 1 / Serial number 240202 / Inform 7 v10.1.2 / D

1's Bedroom

>examine letter
Dear 1 2 3 4 5, 

You have won the Norwegian Daily Lottery! ...

* * *

Some pretext about the story...

Explanation of git config... Please only use ONE word for your name (No spaces in between!)

Now use the format "git config --global NAME" to tell me your name.

>Marius Von Hagus
Hi, Marius!

Adventure of the Command Line
An Interactive Fiction by Ohana
Release 1 / Serial number 240202 / Inform 7 v10.1.2 / D

Marius's Bedroom

>examine me
As good-looking as ever.

>inventory
You are carrying:
  a letter

>examine letter
Dear Marius Von Hagus, 

You have won the Norwegian Daily Lottery! ...

* * *

Some pretext about the story...

Explanation of git config... Please only use ONE word for your name (No spaces in between!)

Now use the format "git config --global NAME" to tell me your name.

>blah
Please use the required format.

Now use the format "git config --global NAME" to tell me your name.

>blah git config --global blah
That's not a verb I recognise.

Now use the format "git config --global NAME" to tell me your name.

>git config --global blah
That's not a verb I recognise.

Now use the format "git config --global NAME" to tell me your name.

>look
's Bedroom

Now use the format "git config --global NAME" to tell me your name.

* * *

>blah
Please use the required format.

Now use the format "git config --global NAME" to tell me your name.

>git config --global name
Please use the required format.

Now use the format "git config --global NAME" to tell me your name.

* * *

Some pretext about the story...

Explanation of git config... Please only use ONE word for your name (No spaces in between!)

Now use the format "git config --global NAME" to tell me your name.

>blah blah blah
Please use the required format.

What is your name?

>git config --global blah blah blah
Hi, git!

Adventure of the Command Line
An Interactive Fiction by Ohana
Release 1 / Serial number 240202 / Inform 7 v10.1.2 / D

git's Bedroom

* * *

Some pretext about the story...

Explanation of git config... Please only use ONE word for your name (No spaces in between!)

Now use the format "git config --global NAME" to tell me your name.

>blah git confir --global NAME
Please use the required format.

Now use the format "git config --global NAME" to tell me your name.

>blah git config --global NAME
Hi, blah!

Adventure of the Command Line
An Interactive Fiction by Ohana
Release 1 / Serial number 240202 / Inform 7 v10.1.2 / D

blah's Bedroom

* * *

Some pretext about the story...

Explanation of git config... Please only use ONE word for your name (No spaces in between!)

Now use the format "git config --global NAME" to tell me your name.

>d
That's not the format I want. Now TRY AGAIN!! ಠ_ಠ
Now use the format "git config --global NAME" to tell me your name. >

>adsf git config --global
That's not the format I want. Now TRY AGAIN!! ಠ_ಠ
Now use the format "git config --global NAME" to tell me your name. >

>git config --global afdadf
Hi, afdadf!

Adventure of the Command Line
An Interactive Fiction by Ohana
Release 1 / Serial number 240202 / Inform 7 v10.1.2 / D

afdadf's Bedroom

* * *

Some pretext about the story...

Explanation of git config... Please only use ONE word for your name (No spaces in between!)

Now use the format "git config --global NAME" to tell me your name.

>git config  --global RAM
Hi, RAM, welcome! Let's begin. 

Adventure of the Command Line
An Interactive Fiction by Ohana
Release 1 / Serial number 240202 / Inform 7 v10.1.2 / D
 

Explain entering rooms problem

RAM's Bedroom
You are now in your bedroom. *inserts description about the bedroom*

You can see a bedroom door here.

>hello
That's not a verb I recognise.

>ls
That's not a verb I recognise.

>cd
(the bedroom door)
(first opening the bedroom door)

RAM's Office
You are now in your office. *inserts description about your office*

You can see a bedroom door here.

>ls
That's not a verb I recognise.

>cd
(the bedroom door)

RAM's Bedroom
You are now in your bedroom. *inserts description about the bedroom*

You can see a bedroom door here.

>ls
That's not a verb I recognise.

>ls
That's not a verb I recognise.

>cd
(the bedroom door)

RAM's Office
You are now in your office. *inserts description about your office*

You can see a bedroom door here.

* * *

Some pretext about the story...

Explanation of git config... Please only use ONE word for your name (No spaces in between!)

Now use the format "git config --global NAME" to tell me your name.

>git config --global Ohana
Hi, Ohana, welcome! Let's begin. 

Adventure of the Command Line
An Interactive Fiction by Ohana
Release 1 / Serial number 240202 / Inform 7 v10.1.2 / D
 

Explain entering rooms problem

Ohana's Bedroom
You can see a bedroom door here.

>blah
Hi, blah!

Adventure of the Command Line
An Interactive Fiction by Ohana
Release 1 / Serial number 240202 / Inform 7 v10.1.2 / D

blah's Bedroom

* * *

>git config --global Ohana
Hi, Ohana, welcome! Let's begin. 

Adventure of the Command Line
An Interactive Fiction by Ohana
Release 1 / Serial number 240202 / Inform 7 v10.1.2 / D
 

Explain entering rooms problem

Ohana's Bedroom
You can see a bedroom door here.

>cd
(the bedroom door)
(first opening the bedroom door)

Ohana's Office
You can see a bedroom door here.

>cd Office
You can't see any such thing.

>cd Bedroom
Ohana's Bedroom
You can see a bedroom door here.

>git branch
(the bedroom door)

Ohana's Office
You can see a bedroom door here.

>git branch bedroom
Ohana's Bedroom
You can see a bedroom door here.

>git branch office
You can't see any such thing.

>git branch bedroom
Ohana's Office
You can see a bedroom door here.

>git branch
(the bedroom door)

Ohana's Bedroom
You can see a bedroom door here.

>git branch
(the bedroom door)

Ohana's Office
You can see a bedroom door here.

>git branch
(the bedroom door)

Ohana's Bedroom
You can see a bedroom door here.

* * *

>cd
(the bedroom door)
(first opening the bedroom door)

Ohana's Office
You can see a bedroom door here.

>cd bedroom
You can't see any such thing.

>cd Office
You can't see any such thing.

* * *

Some pretext about the story...

Explanation of git config... Please only use ONE word for your name (No spaces in between!)

Now use the format "git config --global NAME" to tell me your name.

>git config --global hana
Hi, hana, welcome! Let's begin. 

Adventure of the Command Line
An Interactive Fiction by Ohana
Release 1 / Serial number 240220 / Inform 7 v10.1.2 / D
 

Explain entering rooms problem

hana's Bedroom
You are now in your bedroom. *inserts description about the bedroom*

You can see a bedroom door here.

>ls
You can go south from here.

>git branch
Here are all rooms you can teleport to: 
hana's Bedroom and hana's Office

>ls
You can go south from here.

* * *

>git branch
Here are all rooms you can teleport to: 
hana's Bedroom and hana's Office

>git branch
Here are all rooms you can teleport to: 
hana's Bedroom and hana's Office

>cd
(the bedroom door)
(first opening the bedroom door)

hana's Office
You can see a bedroom door here.

>ls
You can go north from here.

>git commit
That's not a verb I recognise.

>git merge
room merged

>git push
submitted

>git fetch
room updated

>git add
item  added to list

>git add apple
item apple added to list

>git add apple
item apple added to list

I beg your pardon?

>meow
That's not a verb I recognise.

>git merge
room merged

>git commit
That's not a verb I recognise.

>git
That's not a verb I recognise.

>git push
submitted

>git commit
That's not a verb I recognise.

>git commit
That's not a verb I recognise.

* * *

Some pretext about the story...

Explanation of git config... Please only use ONE word for your name (No spaces in between!)

Now use the format "git config --global NAME" to tell me your name.

>git config --global ohana
Hi, ohana, welcome! Let's begin. 

Adventure of the Command Line
An Interactive Fiction by Ohana
Release 1 / Serial number 240202 / Inform 7 v10.1.2 / D

ohana's Bedroom

>cd
(the letter)
That's not something you can enter.

>cd bedroom
You can't see any such thing.

* * *

>cd Office
You can't see any such thing.

>look
ohana's Bedroom

* * *

Some pretext about the story...

Explanation of git config... Please only use ONE word for your name (No spaces in between!)

Now use the format "git config --global NAME" to tell me your name.

>git config ohana
Hi, ohana!

Adventure of the Command Line
An Interactive Fiction by Ohana
Release 1 / Serial number 240202 / Inform 7 v10.1.2 / D

ohana's Bedroom

* * *

Some pretext about the story...

Explanation of git config... Please only use ONE word for your name (No spaces in between!)

Now use the format "git config --global NAME" to tell me your name.

>gkjh
Please use the required format.

Now use the format "git config --global NAME" to tell me your name.

>git config --global ohana
Please use the required format.

Now use the format "git config --global NAME" to tell me your name.

* * *

Some pretext about the story...

Explanation of git config... Please only use ONE word for your name (No spaces in between!)

Now use the format "git config --global NAME" to tell me your name.

>h
That's not the format I want. ಠ_ಠ
Now use the format "git config --global NAME" to tell me your name. >

* * *

Some pretext about the story...

Explanation of git config... Please only use ONE word for your name (No spaces in between!)

Now use the format "git config --global NAME" to tell me your name.

>hana
Hi, hana!

Adventure of the Command Line
An Interactive Fiction by Ohana
Release 1 / Serial number 240202 / Inform 7 v10.1.2 / D

hana's Bedroom

>d
You can't go that way.

>Hi
That's not a verb I recognise.

>look
hana's Bedroom

* * *

Some pretext about the story...

Explanation of git config... Please only use ONE word for your name (No spaces in between!)

Now use the format "git config --global NAME" to tell me your name.

>huh
That's not a verb I recognise.

Now use the format "git config --global NAME" to tell me your name.

I beg your pardon?

Now use the format "git config --global NAME" to tell me your name.

I beg your pardon?

Now use the format "git config --global NAME" to tell me your name.

* * *

Some pretext about the story...

Explanation of git config... Please only use ONE word for your name (No spaces in between!)

Now use the format "git config --global NAME" to tell me your name.

>ls
That's not the format I want. Now TRY AGAIN!! ಠ_ಠ
Now use the format "git config --global NAME" to tell me your name.

>git config --global Hana
Hi, Hana, welcome! Let's begin. 

Adventure of the Command Line
An Interactive Fiction by Ohana
Release 1 / Serial number 240205 / Inform 7 v10.1.2 / D
 

Explain entering rooms problem

Hana's Bedroom
You are now in your bedroom. *inserts description about the bedroom*

You can see a bedroom door here.

>ls
ls command received.
You can go south from here.
Ignore the next sentence that I can't get rid of yet. -by Dev.
That's not a verb I recognise.

>ls
ls command received.
You can go south from here.
Ignore the next sentence that I can't get rid of yet. -by Dev.
That's not a verb I recognise.

>go east
You can't go that way.

>go west
You can't go that way.

>go west
You can't go that way.

>ls
ls command received.
You can go south from here.
Ignore the next sentence that I can't get rid of yet. -by Dev.
That's not a verb I recognise.

>cd
(the bedroom door)
(first opening the bedroom door)

Hana's Office
You can see a bedroom door here.

>office
That's not a verb I recognise.

>cd bedroom
Hana's Bedroom
You are now in your bedroom. *inserts description about the bedroom*

You can see a bedroom door here.

>cd office
You can't see any such thing.

>go east
You can't go that way.

>cd east
You must name something more substantial.

>git branch east
You must name something more substantial.

>ls
ls command received.
You can go south from here.
Ignore the next sentence that I can't get rid of yet. -by Dev.
That's not a verb I recognise.

>cd
(the bedroom door)

Hana's Office
You can see a bedroom door here.

>ls
ls command received.
You can go north from here.
Ignore the next sentence that I can't get rid of yet. -by Dev.
That's not a verb I recognise.

>cd
(the bedroom door)

Hana's Bedroom
You are now in your bedroom. *inserts description about the bedroom*

You can see a bedroom door here.

>git branch
(the bedroom door)

Hana's Office
You can see a bedroom door here.

>ls
ls command received.
You can go north from here.
Ignore the next sentence that I can't get rid of yet. -by Dev.
That's not a verb I recognise.

* * *

>ls
That's not the format I want. Now TRY AGAIN!! ಠ_ಠ
Now use the format "git config --global NAME" to tell me your name.

>git config --global ohana
Hi, ohana, welcome! Let's begin. 

Adventure of the Command Line
An Interactive Fiction by Ohana
Release 1 / Serial number 240220 / Inform 7 v10.1.2 / D
 

Explain entering rooms problem

ohana's Bedroom
You are now in your bedroom. *inserts description about the bedroom*

You can see a bedroom door here.

>ls
ls command received.
You can go south from here.
That's not a verb I recognise.

>ls
ls command received.
You can go south from here.
That's not a verb I recognise.

* * *

Some pretext about the story...

Explanation of git config... Please only use ONE word for your name (No spaces in between!)

Now use the format "git config --global NAME" to tell me your name.

>meow
Please use the required format.

Now use the format "git config --global NAME" to tell me your name. >

>git config --global meow
Hi, meow!

Adventure of the Command Line
An Interactive Fiction by Ohana
Release 1 / Serial number 240202 / Inform 7 v10.1.2 / D

meow's Bedroom

* * *

Some pretext about the story...

Explanation of git config... Please only use ONE word for your name (No spaces in between!)

Now use the format "git config --global NAME" to tell me your name.

>ohana
That's not a verb I recognise.

Now use the format "git config --global NAME" to input your name.

* * *

Some pretext about the story...

Explanation of git config... Please only use ONE word for your name (No spaces in between!)

Now use the format "git config --global NAME" to tell me your name.

>sdfad
That's not the format I want. Now TRY AGAIN!! ಠ_ಠ
Now use the format "git config --global NAME" to tell me your name. >

>git config --adfa
That's not the format I want. Now TRY AGAIN!! ಠ_ಠ
Now use the format "git config --global NAME" to tell me your name. >

>git config --global ಠ_ಠ
Hi, _, welcome! Let's begin. 

Adventure of the Command Line
An Interactive Fiction by Ohana
Release 1 / Serial number 240202 / Inform 7 v10.1.2 / D

_'s Bedroom

* * *

Some pretext about the story...

Explanation of git config... Please only use ONE word for your name (No spaces in between!)

Now use the format "git config --global NAME" to tell me your name.

>wrong
That's not the format I want. Now TRY AGAIN!! ಠ_ಠ
Now use the format "git config --global NAME" to tell me your name. >

>git config --global Ram
Hi, Ram, welcome! Let's begin. 

Adventure of the Command Line
An Interactive Fiction by Ohana
Release 1 / Serial number 240202 / Inform 7 v10.1.2 / D
 

Explain entering rooms problem

Ram's Bedroom
You can see a bedroom door here.

>back
That's not a verb I recognise.

* * *

Some pretext about the story...

Explanation of git config... Please only use ONE word for your name (No spaces in between!)

Now use the format "git config --global NAME" to tell me your name.

>中文可以嗎
Hi, !

Adventure of the Command Line
An Interactive Fiction by Ohana
Release 1 / Serial number 240202 / Inform 7 v10.1.2 / D

's Bedroom